%%%%%%%%%%%%%%%%%%%%
%......%....%......%
%.%%...%.%%.%..%%.%%
%P%..%........%..G.%
%.%..%.%%%%.%.%.%%.%
%...%%...%%.%....%.%
%.%..%.%......%....%
%.%%...%.%%%.%..%%.%
%....%.............%
%%%%%%%%%%%%%%%%%%%%