%%%%%%%%%%%%%%%%%%%%
%......% G  %......%
%.%%...%%  %%...%%.%
%....%........%....%
%.%%.%.%%%%%%.%.%%.%
%........P.........%
%.%..%........%....%
%.%%...%%  %%...%%.%
%..................%
%%%%%%%%%%%%%%%%%%%%