%%%%%%%%%%%%%%%%%%%%
%......%  P  ......%
%.%%...% %%%%...%%.%
%....%........%....%
%.%..%.% %%%%.%.%%.%
%...%%...%%......%.%
%.%..%.%......%....%
%.%%...% %% %...%%.%
%....%...G..%......%
%%%%%%%%%%%%%%%%%%%%
