%%%%%%%%%%%%%%%%%%%%%%%%%%%%%%%%
%G P...........................%
%%%%%%%%%%%%%%%%%%%%%%%%%%%%%% %
%%%%%%%%%%%%%%%%%%%%%%%%%%%%%% %
%%%%%%%%%%%%%%%%%%%%%%%%%%%%%% %
%..............................%
%%%%%%%%%%%%%%%%%%%%%%%%%%%%%%%%
