%%%%%%%%%%%%%%%%%%%%%%%%%%%%%
%.............%.............%
%.%%%%.%%%%%%.%.%%%%%%.%%%%.%
%.%%%%.%%%%%%.%.%%%%%%.%%%%.%
%...........................%
%.%%%%.%.%%%%%%%%%%%.%.%%%%.%
%......%......%......%......%
%%.%%%.%%%%%% % %%%%%%.%%%.%%
%%.%%%.%             %.%%%.%%
%......% %%.%% %%.%% %.%....%
%.%%.%.  %..% G %..%  .%.%%.%
%.%%.%.% %.%%%%%%%.% %.%.%%.%.
%....%.%             %......%
%%%.%%.% %%%%%%%%%%% %.%%.%%%
%.............%.............%
%.%%%%.%%%%%%.%.%%%%%%.%%%%.%
%....%........P........%....%
%%%%.%.%.%%%%%%%%%%%.%.%.%%%%
%......%......%......%......%
%.%%%%%%%%%%%.%.%%%%%%%%%%%.%
%...........................%
%%%%%%%%%%%%%%%%%%%%%%%%%%%%%