%%%%%%%%%%%%%%%%%%%%
%......%....%......%
%.%%...%.%%.%..%%.%%
%.%..%.%....%.%....%
%.%..%P%.%%.%G%.%%.%
%...%%.%.%%.%......%
%.%..%........%.%..%
%.%..%.%.%.%.%..%%.%
%......%...%.......%
%%%%%%%%%%%%%%%%%%%%